Afghanistan AFG
Albania	ALB
Algeria	ALG
American Samoa*	ASA
Andorra	AND
Angola	ANG
Antigua and Barbuda	ANT
Argentina	ARG
Armenia	ARM
Aruba*	ARU
Australia	AUS
Australasia	ANZ
Austria	AUT
Azerbaijan	AZE
The Bahamas	BAH
Bahrain	BRN
Bangladesh	BAN
Barbados	BAR
Belarus	BLR
Belgium	BEL
Belize	BIZ
Bermuda*	BER
Benin	BEN
Bhutan	BHU
Bohemia	BOH
Bolivia	BOL
Bosnia and Herzegovina	BIH
Botswana	BOT
Brazil	BRA
British Virgin Islands*	IVB
British West Indies	BWI
Brunei	BRU
Bulgaria	BUL
Burkina Faso	BUR
Burundi	BDI
Cambodia	CAM
Cameroon	CMR
Canada	CAN
Cape Verde	CPV
Cayman Islands*	CAY
Central African Republic	CAF
Chad	CHA
Chile	CHI
China	CHN
Colombia	COL
Comoros	COM
Congo, Republic of the	CGO
Congo, Democratic	COD
Republic of the Cook Islands*	COK
Costa Rica	CRC
Cote d'Ivoire	CIV
Croatia	CRO
Cuba	CUB
Cyprus	CYP
Czechia	CZE
Czechoslovakia	TCH
Denmark	DEN
Djibouti	DJI
Dominica	DMA
Dominican Republic	DOM
East Germany	GDR
East Timor (Timor-Leste)	TLS
Ecuador	ECU
Egypt	EGY
El Salvador	ESA
Equatorial Guinea	GEQ
Eritrea	ERI
Estonia	EST
Eswatini 	SWZ
Ethiopia	ETH
Fiji	FIJ
Finland	FIN
France	FRA
Gabon	GAB
The Gambia	GAM
Georgia	GEO
Germany	GER
Ghana	GHA
Greece	GRE
Grenada	GRN
Guam*	GUM
Guatemala	GUA
Guinea	GUI
Guinea-Bissau	GBS
Guyana	GUY
Haiti	HAI
Honduras	HON
Hong Kong*	HKG
Hungary	HUN
Iceland	ISL
Individual Olympic athletes	IOA
Independent Olympic Participants	IOP
India	IND
Indonesia	INA
Iran	IRI
Iraq	IRQ
Ireland	IRL
Israel	ISR
Italy	ITA
Jamaica	JAM
Japan	JPN
Jordan	JOR
Kazakhstan	KAZ
Kenya	KEN
Kiribati	KIR
Korea, North (PDR of Korea)	PRK
Korea, South	KOR
Kosovo	KOS
Kuwait	KUW
Kyrgyzstan	KGZ
Laos	LAO
Latvia	LAT
Lebanon	LIB
Lesotho	LES
Liberia	LBR
Libya	LBA
Liechtenstein	LIE
Lithuania	LTU
Luxembourg	LUX
Madagascar	MAD
Malawi	MAW
Malaya	MAL
Malaysia	MAS
Maldives	MDV
Mali	MLI
Malta	MLT
Marshall Islands	MHL
Mauritania	MTN
Mauritius	MRI
Mexico	MEX
Micronesia (Federated States of)	FSM
Mixed Team (1896 to 1904)	ZZX
Moldova	MDA
Monaco	MON
Mongolia	MGL
Montenegro	MNE
Morocco	MAR
Mozambique	MOZ
Myanmar (Burma)	MYA
Namibia	NAM
Nauru	NRU
Nepal	NEP
Netherlands	NED
Netherlands Antilles*	AHO
New Zealand	NZL
Nicaragua	NCA
Niger	NIG
Nigeria	NGR
North Borneo	NBO
North Macedonia	MKD
North Yemen	YAR
Norway	NOR
Oman	OMA
Pakistan	PAK
Palau	PLW
Palestine*	PLE
Panama	PAN
Papua New Guinea	PNG
Paraguay	PAR
Peru	PER
Philippines	PHI
Poland	POL
Portugal	POR
Puerto Rico*	PUR
Qatar	QAT
Refugee Olympic Athletes	ROA
Republic of China	ROC
Romania	ROU
Russia	RUS
Russian Empire	RU1
Rwanda	RWA
Saar	SAA
Saint Kitts and Nevis	SKN
Saint Lucia	LCA
Saint Vincent and the Grenadines	VIN
Samoa	SAM
San Marino	SMR
Sao Tome and Principe	STP
Saudi Arabia	KSA
Senegal	SEN
Serbia	SRB
Serbia and Montenegro	SCG
Seychelles	SEY
Sierra Leone	SLE
Singapore	SIN
Slovakia	SVK
Slovenia	SLO
Solomon Islands	SOL
Somalia	SOM
South Africa	RSA
South Sudan	SSD
South Yemen	YMD
Soviet Union	URS
Spain	ESP
Sri Lanka	SRI
Sudan	SUD
Suriname	SUR
Sweden	SWE
Switzerland	SUI
Syria	SYR
Taiwan (Chinese Taipei)	TPE
Tajikistan	TJK
Tanzania	TAN
Thailand	THA
Togo	TOG
Tonga	TGA
Trinidad and Tobago	TRI
Tunisia	TUN
TÃ¼rkiye	TUR
Turkmenistan	TKM
Tuvalu	TUV
Uganda	UGA
Ukraine	UKR
Unified Team	EUN
Unified Team of Germany	EUA
United Arab Emirates	UAE
United Arab Republic	RAU
United Kingdom (Great Britain)	GBR
United States	USA
Uruguay	URU
Uzbekistan	UZB
Vanuatu	VAN
Venezuela	VEN
Vietnam	VIE
Virgin Islands*	ISV
West Germany	FRG
West Indies Federation (Antilles)	ANT
Yemen	YEM
Yugoslavia	YUG
Zambia	ZAM
Zimbabwe	ZIM

AIA	 Anguilla
ANT	 Antigua and Barbuda	
AUS	 Australia	


BAH	 Bahamas	
BAN	 Bangladesh	
BAR	 Barbados	
BER	 Bermuda	
BIZ	 Belize
BOT	 Botswana	
BRU	 Brunei	

CAN	 Canada	
CAY	 Cayman Islands	
CMR	 Cameroon	
COK	 Cook Islands	
CYP	 Cyprus	

DMA	 Dominica	
ENG	 England	

FLK	 Falkland Islands
FIJ	 Fiji1	
GAM	 The Gambia	
GGY	 Guernsey	
GHA	 Ghana	
GIB	 Gibraltar	
GRN	 Grenada	
GUY	 Guyana	

IND	 India	
IOM	 Isle of Man	
IVB	 British Virgin Islands	
JAM	 Jamaica	
JEY	 Jersey	
KEN	 Kenya	
KIR	 Kiribati	
LCA	 Saint Lucia	
LES	 Lesotho	
MAS	 Malaysia	
MAW	 Malawi	
MDV	 Maldives	
MLT	 Malta	
MOZ	 Mozambique	
MRI	 Mauritius	
MSR	 Montserrat
NAM	 Namibia	
NFK	 Norfolk Island	
NGR	 Nigeria	
NIR	 Northern Ireland	
NIU	 Niue	
NRU	 Nauru	
NZL	 New Zealand	
PAK	 Pakistan	
PNG	 Papua New Guinea	
RSA	 South Africa	
RWA	 Rwanda	
SAM	 Samoa	
SCO	 Scotland	
SEY	 Seychelles	
SHN	 Saint Helena	
SGP	 Singapore	
SKN	 Saint Kitts and Nevis
SLE	 Sierra Leone	
SOL	 Solomon Islands	
SRI	 Sri Lanka	
SVG	 Saint Vincent and the Grenadines	
SWZ	 Swaziland 	
TAN	 Tanzania	
TCA	 Turks and Caicos Islands	
TGA	 Tonga	
TTO	 Trinidad and Tobago	
TUV	 Tuvalu	
UGA	 Uganda	
VAN	 Vanuatu	
WAL	 Wales	
ZAM	 Zambia	NRH (1954)